+++++++++++++++++++
+p---+-----+------+
+-++-+-+++---++++-+
+-+--+--++++-+-+--+
+-+++++-++++---+-+++
+--+--+---++++-+-+-+
++-+-++-+-++++++---+
+----++-+----++--+++
+-+++---+++++++-++++
+-----+-----+-----*+
++++++++++++++++++++